list	List
show	Show
dateformat	EEE, d MMM yyyy HH:mm:ss z
add	Add
edit	Edit
delete	Delete
top	TOP
admintop	Admin Top
admin	Admin
reset	Reset
add_confirm	Confirm Add
add_exec	Exec Add
has_error	There are input errors
add_complete	Complete add
edit_confirm	Confirm Edit
edit_exec	Exec Edit
edit_complete	Complete edit
delete_confirm	Confirm Delete
delete_exec	Exec Delete
delete_complete	Complete delete
show_next	show next